00000000000001000000-
22222222222220010000-
00000010000020000100-
02222222222220000000-
02000000100000000010-
02222222222222222220-
01000000001000000020-
02222222222222222220-
02000010000001000000-
02022202220222022222-
02220222022202220100-
00001000000010000000